轰堂大笑	哄堂大笑
顶礼模拜	顶礼膜拜
艰壁清野	坚壁清野
头昏脑胀	头昏脑涨
一麟半爪	一鳞半爪
一望无银	一望无垠
既使	即使
甜静	恬静
九洲	九州
更叠	更迭
万古常青	万古长青
不记其数	不计其数
要言不繁	要言不烦
纵恿	怂恿
正襟威坐	正襟危坐
表本兼治	标本兼治
密而不宣	秘而不宣
老声	老生
装钉	装订
朴朔迷离	扑朔迷离
留恋忘返	留连忘返
措火积薪	厝火积薪
巧立明目	巧立名目
彰善惮恶	彰善瘅恶
圆艺	园艺
松驰	松弛
穷穷孑立	穷穷茕立
因地治宜	因地制宜
爆乱	暴乱
诺大	偌大
迭床架屋	叠床架屋
弦律	旋律
暮蔼沉沉	暮霭沉沉
自学成才	自学成材
步履维坚	步履维艰
持才傲物	恃才傲物
名信片	明信片
躁热	燥热
旅力过人	膂力过人
眼花撩乱	眼花缭乱
以身作责	以身作则
惨绝人圜	惨绝人寰
蝉连冠军	蝉联冠军
强词夺礼	强词夺理
五彩斑烂	五彩斑斓
风彩动人	风彩动人
大伤原气	大伤元气
世无前例	史无前例
穷穷孑立	茕茕孑立
良秀	良莠
教悔	教诲
老陈持重	老成持重
投鼠计器	投鼠忌器
仲栽委员	仲裁委员
造形	造型
制肘	掣肘
入情入礼	入情入理
不惶顾及	不遑顾及
如梗在喉	如鲠在喉
符会	附会
拖踏	拖沓
繁文溽节	繁文缛节
严惩不待	严惩不贷
得垄望蜀	得陇望蜀
危言悚听	危言耸听
凋虫小技	雕虫小技
爱乌及屋	爱屋及屋
告馨	告罄
心劳日绌	心劳日绌
坦胸露臂	袒胸露臂
肓目	盲目
开天劈	开天辟
无忘之灾	无妄之灾
科头洗足	科头洗足
别出新裁	别出心裁
严阵以代	严阵以待
震聋发聩	振聋发聩
披红带花	披红戴花
山洪爆发	山洪暴发
默守成规	墨守成规
认罪服法	认罪伏法
礼上往来	礼尚往来
稠怅	惆怅
遨翔	翱翔
立杆见影	立竿见影
浪废金钱	浪费金钱
湎怀	缅怀
穷途没路	穷途没路
提心掉胆	提心吊胆
毗临	毗邻
一脉相成	一脉相承
各施其职	各施其职
显身说法	现身说法
反来复去	反来覆去
白壁微瑕	白璧微瑕
妄费心机	枉费心机
各行其事	各行其是
坐收鱼利	坐收渔利
恰商	洽商
膺品	赝品
危如磊卵	危如累卵
演译推理	演绎推理
震憾	震撼
斩钉接铁	斩钉截铁
鹤戾	鹤唳
舍身取义	舍生取义
观磨	观摩
莹光	荧光
顶力相助	鼎力相助
苍海桑田	沧海桑田
丰富多采	丰富多彩
诅丧	沮丧
震奋人心	振奋人心
响午	晌午
穿流不息	川流不息
厉厉在目	历历在目
星罗旗布	星罗棋布
风声鹤戾	风声鹤唳
指手划脚	指手画脚
降龙服虎	降龙伏虎
嫉恶如仇	疾恶如仇
爽心悦目	赏心悦目
宁缺毋烂	宁缺毋滥
三令五伸	三令五申
耳根清静	耳根清净
扇动暴乱	煽动暴乱
粗旷	粗犷
得不尝失	得不偿失
废尽心思	费尽心思
如法泡制	如法炮制
毁家抒难	毁家纾难
细枝末结	细枝末节
开诚不公	开诚布公
陷井	陷阱
绿草如荫	绿草如茵
半途而费	半途而废
骠悍	剽悍
明火执杖	明火执仗
势如爆竹	势如破竹
煤汽机	煤气机
开中明义	开宗明义
契而不舍	锲而不舍
肿涨	胀涨
心心相应	心心相印
箴口不言	箴口不言
羽扇伦巾	羽扇纶巾
黯无天日	暗无天日
浑玉朴金	浑玉璞金
坐阵	坐镇
演译	演绎
九洲方圆	九州方圆
食不裹腹	食不果腹
雕彻	雕彻
气慨	气概
同等学历	同等学力
暗然销魂	黯然销魂
置若惘闻	置若罔闻
坦城	坦诚
至理明言	至理名言
以偏盖全	以偏概全
余勇可沽	余勇可沽
珠连璧合	珠联璧合
腊纸	蜡纸
扬扬洒洒	洋洋洒洒
张惶失措	张皇失措
重重迭迭	重重叠叠
困兽尤斗	困兽犹斗
山青水秀	山清水秀
屯积居奇	囤积居奇
以身徇国	以身殉国
延袭成规	沿袭成规
晃子	幌子
深致欠意	深致歉意
脸色杀白	脸色煞白
纷至踏来	纷至沓来
浅尝则止	浅尝则止
欢呼鹊跃	欢呼雀跃
一应具全	一应俱全
试目以待	拭目以待
廖若晨星	寥若晨星
防碍	妨碍
重迭	重叠
大才小用	大材小用
九宵	九霄
恢谐	诙谐
浮光略影	浮光掠影
乌烟脏气	乌烟瘴气
改斜归正	改邪归正
投投是道	头头是道
爱乌及屋	爱屋及乌
锁屑	琐屑
莫中一是	莫衷一是
掘起	崛起
忘夫所以	忘乎所以
运筹惟幄	运筹帷幄
性格粗旷	性格粗旷
义气风发	意气风发
各施其职	各司其职
蔽病	弊病
奕棋	弈棋
奢糜	奢靡
抓耳扰腮	抓耳扰腮
万冠家财	万贯家财
不共带天	不共戴天
鬼域技俩	鬼蜮技俩
老声常谈	老生常谈
因才施教	因材施教
永决	永诀
茫无头序	茫无头绪
心安礼得	心安理得
治丝益纷	治丝益棼
愤发	奋发
名门旺族	名门望族
不寒而立	不寒而栗
标柄千古	彪柄千古
明查暗访	明察暗访
证卷	证券
退化变质	蜕化变质
远大报负	远大抱负
死不冥目	死不瞑目
大放獗词	大放厥词
脑火	恼火
敬配	敬佩
谆谆告戒	谆谆告诫
编篡	编纂
杂杳	杂沓
火山暴发	火山爆发
肖象	肖像
偷工简料	偷工减料
学识休养	学识修养
语无论次	语无伦次
处心集虑	处心积虑
凉干	晾干
蓄意抱复	蓄意报复
先发治人	先发制人
灸手可热	炙手可热
床第	床笫
仗义直言	仗义执言
惩一禁百	惩一儆百
罢绌百家	黜绌百家
报怨不堪	抱怨不堪
格守	恪守
炫目	眩目
淄铢必较	锱铢必较
生死悠关	生死攸关
词不达义	词不达意
深明大意	深明大义
劈谣	辟谣
幅圆辽阔	幅员辽阔
金刚努目	金刚怒目
栽脏陷害	栽赃陷害
一股作气	一鼓作气
瞻养	赡养
斩将骞旗	斩将骞旗
循序前进	循序前进
手屈一指	首屈一指
题纲挈领	提纲挈领
自我吹吁	自我吹嘘
做为 作为
全愈	痊愈
胀红了脸	涨红了脸
口干舌躁	口干舌燥
沧茫大海	苍茫大海
插科打浑	插科打诨
前扑后继	前仆后继
甘败下风	甘拜下风
作歇时间	作息时间
桀傲不驯	骜傲不驯
描模	描摹
歌舞生平	歌舞升平
以德抱怨	以德报怨
一杯	一杯
前踞后恭	前倨后恭
厉精图治	励精图治
回光反照	回光返照
纵横捭合	纵横捭阖
强焊	强悍
消声匿迹	销声匿迹
屈意逢迎	曲意逢迎
魁丽	瑰丽
尽心极力	尽心竭力
趁心如意	称心如意
材华	才华
一泄千里	一泻千里
勉厉	勉励
开源截流	开源节流
肆业	肄业
誉写文章	誊写文章
直抒胸意	直抒胸臆
杂踏	杂沓
声名雀起 	声名鹊起
义无返顾	义无反顾
付之东流	付诸东流
戳力同心	戮力同心
令人目炫	令人目眩
急燥	急躁
磬竹难书	罄竹难书
斩将骞旗	斩将搴旗
官运享通	官运亨通
根深底固	根深蒂固
祖传密方	祖传秘方
弃甲拽兵	弃甲拽兵
穿串	穿插
发号司令	发号司令
冒然	贸然
天下糜然	天下靡然
自立更生	自力更生
蔽帚自珍	敝帚自珍
天经地仪	天经地义
支无其词	支吾其词
壅荣华贵	雍荣华贵
摇摇欲堕	摇摇欲坠
陨身不恤	殒身不恤
疾贤妒能	嫉贤妒能
歇事宁人	歇事宁人
略夺	掠夺
估息	姑息
纲纪废驰	纲纪废弛
面面具到	面面俱到
佼洁	皎洁
铺张扬利	铺张扬厉
张惶	张皇
杀君夺位	弑君夺位
举一返三	举一反三
供献巨大	贡献巨大
一笔钩销	一笔勾销
杀费苦心	煞费苦心
勘平叛乱	戡平叛乱
冷不妨	冷不防
吊虎离山	调虎离山
巧装打扮	乔装打扮
势均力抵	势均力敌
计日成功	计日程功
讫今为止	迄今为止
一诺千斤	一诺千金
寒喧	寒暄
报消	报销
修养生息	休养生息
沏澈	清澈
估名钓誉	沽名钓誉
仓桑	沧桑
渊远流长	源远流长
余勇可沽	余勇可贾
宁死不曲	宁死不屈
振济灾民	赈济灾民
五彩斑烂	五彩斓烂
狂忘	狂妄
既往开来	继往开来
卫戌	卫戍
春光溶溶	春光融融
专心至志	专心致致
接恰	接洽
风糜一时	风靡一时
模范事绩	模范事迹
份內之事	分內之事
精精业业	兢兢业业
层峦迭障	层峦叠障
脱颍而出	脱颖而出
文笔奇倔	文笔奇崛
教梭	教唆
虚座以待	虚左以待
怆皇	仓皇
热涨冷缩	热胀冷缩
动则得咎	动则得咎
味同嚼腊	味同嚼蜡
追朔	追溯
下车一始	下车伊始
婷婷玉立	亭亭玉立
朦懂无知	懵懂无知
不可思异	不可思议
焕散	涣散
沤心沥血	呕心沥血
钓消执照	吊销执照
暗然	黯然
修茸一新	修葺一新
不明一文	不名一文
阔卓	阔绰
因噎费食	因噎废食
不加思索	不假思索
名列前矛	名列前茅
坠落腐化	坠落腐化
除恶勿尽	除恶务尽
积毁消骨	积毁销骨
错手不及	措手不及
带罪立功	戴罪立功
层峦叠障	层峦叠嶂
弹精竭虑	殚精竭虑
中心感谢	衷心感谢
言之足足	言之凿凿
无精打彩	无精打彩
玲俐	伶俐
高吭	高亢
龙盘虎据	龙盘虎踞
沾污清白	玷污清白
卑却	卑怯
神彩飞扬	神采飞扬
终生大事	终身大事
形影相掉	形影相吊
粗制烂造	粗制滥造
走头无路	走投无路
修茸	修葺
万相更新	万象更新
泊来品	舶来品
遗笑大方	贻笑大方
造谣装骗	招摇撞骗
曲高合寡	曲高和寡
合衷共济	和衷共济
令人乍舌	令人咋舌
苦思瞑想	苦思冥想
沾污清白	沾污清白
百战不贻	百战不殆
蜇居	蛰居
纹身	文身
蹉商	嗟商
不详之兆	不祥之兆
委屈求全	委曲求全
布署已定	部署已定
巧夺天公	巧夺天工
薄暮冥冥	薄暮暝暝
震撼	震撼
足涉	跋涉
横征暴殓	横征暴敛
缀学	辍学
宵衣干食	宵衣旰食
依仗权势	倚仗权势
肆无忌殚	肆无忌惮
爆躁	暴躁
地大物搏	地大物博
再接再厉	再接再厉
璀烂夺目	璀璨夺目
羁拌	羁绊
评头评足	品头品足
呕气	怄气
万变不离其中	万变不离其宗
留芳百世	流芳百世
不浮众望	不孚众望
下功夫	下工夫
循序前进	循序渐进
痴心枉想	痴心妄想
工力悉抵	工力悉敌
穿带	穿戴
并行不背	并行不悖
意正词严	义正词严
绿树成阴	绿树成荫
凭心而论	平心而论
自翊	自诩
以警效尤	以儆效尤
越俎代包	越俎代包
打腊	打蜡
箴口不言	缄口不言
罢绌百家	罢黜百家
从常计议	从长计议
投机捣把	投机倒把
应接不遐	应接不暇
萎糜不振	萎靡不振
言不由中	言不由衷
延申	延伸
针炙	针灸
晕腥	荤腥
仗义输财	仗义疏财
身体嬴弱	身体羸弱
反工	返工
括不知耻	恬不知耻
造事者	肇事者
灿然一笑	粲然一笑
漫条斯理	慢条斯理
素昧平身	素昧平生
安份守己	安分守己
坐以待毖	坐以待毙
自抱自弃	自暴自弃
左右开工	左右开弓
不接不离	不即不离
鞠躬尽粹	鞠躬尽瘁
武装爆动	武装暴动
按途索骥	按图索骥
引伸义	引申义
对恃	对峙
水利发电	水力发电
不接不离	不接不离
喜出往外	喜出望外
穷兵渎武	穷兵黩武
挑畔	挑衅
一鼓足气	一鼓作气
成绩蜚然	成绩斐然
凶相必露	凶相毕露
如法炮治	如法炮制
富丽唐皇	富丽堂皇
照然若揭	昭然若揭
布衣疏食	布衣蔬食
生杀与夺	生杀予夺
连锁反映	连锁反应
闻过饰非	文过饰非
愤发图强	奋发图强
篷筚生辉	蓬荜生辉
做月子	坐月子
旁证博引	旁征博引
持才傲物	持才傲物
鬼斧神功	鬼斧神工
撕杀	厮杀
炉火成青	炉火纯青
有条不稳	有条不紊
入不付出	入不敷出
门廷若市	门庭若市
暗然泪下	黯然泪下
迷天大谎	弥天大谎
无人问斤	无人问津
趋之若骛	趋之若鹜
显象管	显像管
渡假村	度假村
言之足足	言之足足
尤如	犹如
痉孪	痉挛
其乐溶溶	其乐融融
范筹	范畴
杀戳	杀戮
能曲能伸	能屈能伸
水笼头	水龙头
坦护	袒护
披艰执锐	披坚执锐
沾辱	沾辱
喧然大波	轩然大波
敖敖待哺	嗷嗷待哺
买牍还珠	买椟还珠
除旧补新	除旧布新
贻然自得	怡然自得
涂毒生灵	荼毒生灵
一愁莫展	一筹莫展
粗枝大意	粗枝大叶
偃苗助长	揠苗助长
熏陶	熏陶
吹毛求刺	吹毛求疵
诛连无辜	株连无辜
五体头地	五体投地
无是生非	无事生非
张灯结采	张灯结彩
炉火成青	炉火成青
峻工	竣工
拥塞不通	壅塞不通
诩诩如生	栩栩如生
儒子可教	孺子可教
心恢意懒	心灰意懒
泰	泰
战战惊惊	战战兢兢
自侍	自恃
圆地圆艺	园地园艺
括不知耻	括不知耻
按装电话	安装电话
罗唆	啰唆
沦肌夹髓	沦肌浃髓
兵慌马乱	兵荒马乱
农名 农民
坚难困苦	艰难困苦
通货膨涨	通货膨胀
欢渡	欢度
大廷广众	大庭广众
渊远流长	源源流长
不作为训	不作为训
轶序井然	秩序井然
出类拔粹	出类拔萃
有持无恐	有恃无恐
一劳永易	一劳永逸
消遥法外	逍遥法外
刮蹭 剐蹭
昏馈无能	昏聩无能
濑口	漱口
暄闹	喧闹
司空见怪	司空见怪
开天劈地	开天辟地
坐想其成	坐享其成
弱不经风	弱不禁风
倍受欢迎	备受欢迎
饮鸠止渴	饮鸩止渴
如期峻工	如期竣工
老俩口	老两口
揣揣不安	惴惴不安
草管人命	草菅人命
大杀风景	大煞风景
五色斑澜	五色斑斓
羁靡	羁縻
凤冠霞披	凤冠霞帔
步入正规	步入正轨
装祯	装帧
脏款	赃款
喧染	渲染
抓耳扰腮	抓耳挠腮
麻木不忍	麻木不仁
摇摇欲堕	摇摇欲堕
直接了当	直截了当
含辛如苦	含辛茹苦
炯然	迥然
啼听	谛听
声音宏亮	声音洪亮
恶灌满盈	恶贯满盈
杀君夺位	杀君夺位
涌跃报名	踊跃报名
盘根错结	盘根错节
老奸巨滑	老奸巨猾
情不自尽	情不自禁
贬眼	眨眼
照本宣课	照本宣科
金殴无缺	金瓯无缺
望而怯步	望而怯步
精焊	精悍
委屈婉转	委曲婉转
瞄摹	描摹
瑕迩闻名	遐迩闻名
佳言懿行	嘉言懿行
丢人显眼	丢人现眼
按步就班	按部就班
贯输	灌输
暴舔天物	暴殄天物
扶老偕幼	扶老携幼
狐度	弧度
成出不穷	层出不穷
脑羞成怒	恼羞成怒
曲打成招	屈打成招
鬼域技俩	鬼蜮伎俩
凑和	凑合
有口皆杯	有口皆碑
精诚所致	精诚所至
雕彻	雕砌
真缔	真谛
前车之戒	前车之戒
涣然一新	焕然一新
拾人牙惠	拾人牙慧
一见衷情	一见钟情
协从	胁从
吁寒问暖	嘘寒问暖
安置若素	安之若素
布署	部署
大多类同	大多雷同
沽恶不悛	沽恶不怙
尾大不吊	尾大不掉
势不可挡	势不可当
推心至腹	推心置腹
不温不火	不瘟不火
绝不罢休	决不罢休
别出心才	别出心裁
针贬	针砭
收来人心	收揽人心
辨证法	辩证法
浅尝则止	浅尝辄止
鸩形鹄面	鸠形鹄面
严正申明	严正声明
以一挡十	以一当十
心旷神饴	心旷神怡
磨肩擦背	摩肩擦背
诋砺	砥砺
事得其反	适得其反
飞扬拔扈	飞扬跋扈
能言善辨	能言善辩
熟练	熟练
志大材疏	志大才疏
利害悠关	利害攸关
仁致义尽	仁至义尽
坠落腐化	堕落腐化
圆林圆丁	园林园丁
爆发户	暴发户
瞳憬	憧憬
门里出生	门里出身
歇事宁人	息事宁人
轻歌慢舞	轻歌曼舞
英雄倍出	英雄辈出
疏峻	疏浚
可望不可	可望不可
一盖而论	一概而论
分庭抗理	分庭抗礼
器度不凡	气度不凡
专心至志	专心致志
心劳日绌	心劳日拙
永往直前	勇往直前
蜂涌而至	蜂拥而至
断章取意	断章取义
军事布署	军事部署
一杯黄土	一抔黄土
鬼鬼崇崇	鬼鬼祟祟
不既不离	不即不离
一獗不振	一蹶不振
惹事生非	惹是生非
墙恒	墙垣
万马齐暗	万马齐喑
含蓄蕴籍	含蓄蕴藉
不求深解	不求甚解
义气用事	意气用事
如丧考比	如丧考妣
一如继往	一如既往
如雷灌耳	如雷贯耳
大至	大致
洗耳躬听	洗耳恭听
娇揉造作	矫揉造作
有持无恐	有持无恐
独挡一面	独当一面
斧底抽薪	釜底抽薪
轮功行赏	论功行赏
惩前毙后	惩前毖后
老态龙肿	老态龙钟
为富不忍	为富不仁
意兴阑姗	意兴阑珊
沆泄一气	沆瀣一气
暴烈恣睢	暴烈恣睢
央央大国	泱泱大国
抒难	纾难
呕歌	讴歌
夸夸奇谈	夸夸其谈
末齿不忘	没齿不忘
望风披糜	望风披靡
戳力同心	戳力同心
千古一痛	千古一恸
融汇贯通	融会贯通
令人发直	令人发指
钟灵玉秀	钟灵毓秀
秘决	秘诀
跌挫强敌	迭挫强敌
黄梁美梦	黄粱美梦
流言非语	流言飞语
虎视耽耽	虎视眈眈
赞不决口	赞不绝口
桀傲不驯	桀骜不驯
无细可乘	无隙可乘
无与论比	无与伦比
泥砂俱下	泥沙俱下
两军对恃	两军对峙
痛心嫉首	痛心疾首
募然	蓦然
循章摘句	寻章摘句
远见灼识	远见卓识
文恬武嘻	文恬武嬉
回然不同	迥然不同
和霭可亲	和蔼可亲
璀烂夺目	璀烂夺目
吉详	吉祥
开门缉盗	开门揖盗
谈笑风声	谈笑风生
辩析	辨析
简炼	简练
中裁	仲裁
即然	既然
材疏学浅	才疏学浅
目不瑕接	目不暇接
叹为观之	叹为观止
肺腹之言	肺腑之言
了望	瞭望
歪风斜气	歪风邪气
鬼鬼崇崇	鬼鬼崇崇
天翻地复	天翻地覆
毛骨耸然	毛骨悚然
大声急呼	大声疾呼
白晰	白皙
坐右铭	座右铭
学习肆业	学习肄业
圆丁	园丁
大相径廷	大相径庭
大慨	大概
并发	迸发
不拘小结	不拘小节
契而不舍	契而不舍
大现身手	大显身手
招雪	昭雪
水乳交溶	水乳交融
翁声翁气	瓮声瓮气
揉躏	蹂躏
亵赎	渎赎
凭添	平添
醮水	蘸水
神采弈弈	神采奕奕
立功渎罪	立功渎罪
流览报纸	浏览报纸
后发治人	后发制人
风彩动人	风釆动人
望洋心叹	望洋兴叹
受益非浅	受益匪浅
烁石流金	铄石流金
推陈相见	推诚相见
艰不可摧	坚不可摧
风雨萧萧	风雨潇潇
宥于成见	囿于成见
发扬广大	发扬光大
气势凶凶	气势汹汹
磨崖石刻	摩崖石刻
民生凋蔽	民生凋敝
义不容词	义不容辞
向偶而泣	向隅而泣
付食品	副食品
鞭僻入理	鞭辟入理
图谋不规	图谋不轨
以毒功毒	以毒攻毒
九州	九州
矫糅造作	矫揉造作
额首称庆	额手称庆
言简意骇	言简意赅
胜况空前	盛况空前
莫明其妙	莫名其妙
玩世不公	玩世不恭
中流抵柱	中流砥柱
分岐	分歧
鞭僻入理	鞭辟入里
虚无缥渺	虚无缥缈
糜糜之音	靡靡之音
烦锁	烦琐
一张一驰	一张一弛
理曲词穷	屈曲词穷
无耻滥言	无耻谰言
无艰不摧	无坚不摧
物极必返	物极必反
真知卓见	真知灼见
文诌诌	文绉绉
协从不问	胁从不问
醍醐贯顶	醍醐灌顶
跚跚来迟	姗姗来迟
调以轻心	掉以轻心
火中取粟	火中取栗
翁中捉鳖	翁中捉鳖
冒然从事	贸然从事
驾奴	驾驭
独占螯头	独占鳌头
自名得意	自鸣得意
复没	覆没
申张	伸张
移花截木	移花接木
梦餍	梦魇
冲耳不闻	充耳不闻
踢除	剔除
对针下药	对症下药
欧打	殴打
跃武扬威	跃武扬威
会萃	荟萃
畏崽不前	畏葸不前
峻工验收	竣工验收
老实本份	老实本分
滥芋充数	滥竽充数
相形见拙	相形见拙
宽弘大量	宽宏大量
沾辱	玷辱
出人投地	出人头地
缈视	藐视
怠漫	怠慢
披星带月	披星戴月
钓消执照	吊消执照
古今杂揉	古今杂糅
堵绝浪费	杜绝浪费
愤概	愤慨
人所不耻	人所不齿
沓无音信	杳无音信
尚待商确	尚待商榷
以逸代劳	以逸待劳
急言厉色	疾言厉色
气喘嘘嘘	气喘吁吁
感恩带德	感恩戴德
祸国秧民	祸国殃民
卑却	卑却
寂莫	寂寞
批沙拣金	披沙拣金
一涌而入	一拥而入
爱带	爱戴
污告	诬告
金壁辉煌	金碧辉煌
立功渎罪	立功赎罪
翻复无常	反复无常
磕磕拌拌	磕磕绊绊
奇角之势	掎角之势
丰功伟迹	丰功伟绩
如火如茶	如火如荼
誓不两立	势不两立
感概	感慨
大有稗益	大有裨益
费寝忘食	废寝忘食
函养	涵养
万籁具寂	万籁俱寂
执谜不悟	执迷不悟
全神灌注	全神贯注
和言悦色	和颜悦色
圆林	园林
歪门斜道	歪门邪道
贫脊	贫瘠
沿木求鱼	沿木求鱼
按居乐业	安居乐业
蜇伏	蛰伏
委屈婉转	曲屈婉转
始作踊者	始作俑者
观磨教	观摩教
慎密	缜密
徒坡	陡坡
害躁	害臊
迁徒	迁徙
病入膏盲	病入膏肓
回	回
天然汽	天然气
贮立	伫立
分道扬标	分道扬镳
耳儒目染	耳濡目染
斥之以鼻	嗤之以鼻
其乐淘淘	其乐陶陶
谋取暴利	牟取暴利
藕断丝联	藕断丝连
不堪之论	不刊之论
众口烁金	众口铄金
引伸	引申
浮想连翩	浮想联翩
鸠占雀巢	鸠占鹊巢
题纲	提纲
浸人心脾	浸人心脾
慢不经心	漫不经心
玷亲带故	沾亲带故
层见迭出	层见叠出
世外桃源	世外桃源
安兵不动	按兵不动
评头评足	评头品足
照像机	照相机
指高气扬	高气扬趾
迟钝	迟钝
非夷所思	匪夷所思
身体姿式	身体姿势
商确	商榷
束手待毖	束手待毙
寡不抵众	寡不敌众
百尺杆头	百尺竿头
竭泽而鱼	竭泽而渔
兰天白云	蓝天白云
发号司令	发号施令
集液成裘	集腋成裘
暴烈恣睢	暴戾恣睢
雄纠纠	雄赳赳
污合之众	乌合之众
一喏千金	一诺千金
忍劳忍怨	任劳任怨
百战不贻	百战不贻
不卑不吭	不卑不亢
金榜提名	金榜题名
天礼难容	天理难容
招惹事非	招惹是非
截止目前	截至目前
层峦迭障	层峦叠嶂
惊赅	惊骇
一层不变	一成不变
座落	坐落
明辩是非	明辨是非
精神焕散	精神涣散
相形见拙	相形见绌
气极败坏	气急败坏
绉纹	皱纹
博识恰闻	博识洽闻
残无人道	惨无人道
赌搏	赌博
忘夫所以	忘夫所以
雪中送碳	雪中送炭
反工重来	返工重来
供献	贡献
收来人心	收来人心
穷途没路	穷途末路
宣染	渲染
惮精竭虑	殚精竭虑
不另赐教	不吝赐教
遗害无穷	贻害无穷
循规导矩	循规蹈矩
摄服	慑服
无计之谈	无稽之谈
临摩书法	临摹书法
陪偿	赔偿
森严壁磊	森严壁垒
挤挤一堂	济济一堂
人情事故	人情世故
苦脑	苦恼
振撼	震撼
按装	安装
陈词烂调	陈词滥调
迫不急待	迫不及待
良晨美景	良辰美景
挖墙角	挖墙脚
骄健	矫健
长嘘短叹	长嘘短吁
沉缅往事	沉湎往事
口株笔伐	口诛笔伐
烂竽充数	滥竽充数
声名雀起	声名鹊起
急待	亟待
纂夺	篡夺
事过景迁	事过境迁
严励	严厉
侯车室	候车室
功亏一蒉	功亏一篑
三翻五次	三番五次
死皮癞脸	死皮赖脸
人心项背	人心向背
拥带	拥戴
推崇倍至	推崇备至
床第之私	床笫之私
流览	浏览
望而怯步	望而却步
动则得咎	动则得辄
决对服从	绝对服从
部置	布置
厌厌欲睡	恹恹欲睡
开消	开销
富丽堂黄	富丽堂皇
尝罚	赏罚
测隐之心	恻隐之心
再接再励	再接再厉
欣尝	欣赏
鹿葺	鹿茸
通辑	通缉
作贼心虚	做贼心虚
愤闷不平	愤懑不平
名哲保身	明哲保身
淹没无闻	湮没无闻
烩炙人口	烩炙人口
水泻不通	水泄不通
英雄气慨	英雄气慨
轶序井然	轶序井然
影影约约	隐隐约约
横度长江	横渡长江
意正词严	义横征暴
合盘托出	和盘托出
靡烂不堪	糜烂不堪
湎怀先烈	缅怀先烈
脉博微弱	脉搏微弱
宽敝	宽敞
规距	规矩
雄材大略	雄才大略
理曲词穷	理屈词穷
弄巧成绌	弄巧成绌
手急眼快	手疾眼快
糜日不思	靡日不思
技俩	伎俩
无所不致	无所不至
蛛丝蚂迹	蛛丝马迹
鼎立	鼎力
百练成钢	百炼成钢
貌和神离	貌合神离
忧心冲冲	忧心忡忡
当人不让	当仁不让
脉博	脉搏
漫骂	谩骂
暮蔼	暮霭
披沙捡金	披沙拣金
作奸犯课	作奸犯科
融汇	融会
相辅相承	相辅相成
食不果腹	食不裹腹
坐无虚席	座无虚席
接长补短	截长补短
材华横溢	才华横溢
宽茹	宽恕
蜂涌	蜂拥
刻划人物	刻画人物
不醒人事	不省人事
篷筚生辉	蓬筚生辉
名珠暗投	明珠暗投
拨乱返正	拨乱反正
严悛	严峻
甘败下风	 甘拜下风
飞声文坛	蜚声文坛
历尽坚辛	历尽艰辛
座标系	坐标系
以老卖老	倚老卖老
悚人听闻	耸人听闻
伦落	沦落
财物科	财务科
无耻之犹	无耻之尤
幅射	辐射
整伤	整饬
秀外惠中	秀外慧中
蹒姗	蹒跚
稳操胜卷	稳操胜券
无泄可击	无懈可击
煤碳	煤炭
发韧	发轫
易如翻掌	易如反掌
殉情枉法	徇情枉法
裨官野史	稗官野史
一视同人	一视同仁
爱不失手	爱不释手
辟头盖脸	劈头盖脸
知书达礼	知书达理
弃甲拽兵	弃甲曳兵
破斧沉舟	破釜沉舟
娘两	娘俩
造谣装骗	招谣装骗
留连忘返	流连忘返
珍重其事	郑重其事
漫延	蔓延
云宵	云霄
不贻余力	不遗余力
雷历风行	雷厉风行
粗枝大意	粗枝大意
喝采	喝彩
改弦更章	改弦更张
无礼漫骂	无礼谩骂
完壁归赵	完璧归赵
史无前列	史无前例
悬梁刺骨	悬梁刺股
投桃抱李	投桃报李
阴谋鬼计	阴谋诡计
焚膏既晷	焚膏继晷
甘之如怡	甘之如饴
造旨	造诣
可资借戒	可资借戒
骠肥体壮	膘肥体壮
禁若寒蝉	噤若寒蝉
身体嬴弱	身体嬴弱
不作为训	不足为训
翁中捉鳖	瓮中捉鳖
作歇时间	作歇时间
入场卷	入场券
先理后兵	先礼后兵
引疚自责	引咎自责
察颜观色	察言观色
挺而走险	铤而走险
出奇致胜	出奇制胜
攻城掠地	攻城略地
烩炙人口	脍炙人口
微言大意	微言大义
庸庸录录	庸庸碌碌
桃梨满园	桃李满园
报筹	报酬
披肝厉胆	披肝沥胆
忽然开朗	忽然开朗
自食其利	自食其力
渲泄	宣泄
板上走丸	坂上走丸
前车之戒	前车之鉴
一促而就	一蹴而就
深受蒙敝	深受蒙蔽
居心不测	居心叵测
凋蔽	凋敝
武装	武装
搔痒病	瘙痒病
长嘘短叹	长吁短叹
惨绝人圜	寰绝人圜
脱化	蜕化
精堪	精湛
连篇累椟	连篇累牍
棵粒归仓	颗粒归仓
千锤百练	千锤百炼
越俎代包	越俎代庖
协迫	胁迫
山拗	山坳
藏诟纳污	藏垢纳污
通谍	通牒
挤身三强	跻身三强
不郎不莠	不郎不秀
保护国萃	保护国粹
决择	抉择
世外桃园	世外桃源
激文	檄文
史无前列	 史无前例
振笔急书	振笔疾书
推托责任	推脱责任
不径而走	不胫而走
色厉内忍	色厉内荏
欢渡春节	欢度春节
沿木求鱼	缘木求鱼
缠绵悱测	缠绵悱恻
判若洪沟	判若鸿沟
行踪鬼秘	行踪诡秘
科头洗足	科头跣足
纵横捭合	纵横阖合
伸东击西	声东击西
指高气扬	趾高气扬
金钢钻头	金刚钻头
众目暌暌	众目睽睽
毫无疑议	毫无疑义
战战惊惊	兢兢惊惊
不骄不燥	不骄不躁
哀声叹气	唉声叹气
飞机着落	飞机着陆
掂斤拨两	掂斤播两
沉缅	沉湎
变换莫测	变幻莫测
刻勤刻俭	克勤克俭
脉膊	脉搏
陈陈相应	陈陈相因
敲榨勒索	敲诈勒索
奋斗终身	奋斗终生
起迄	起讫
虎据龙盘	虎踞龙盘
百步串杨	百步穿杨
文渎	文牍
不言而语	不言而喻
付之东流	付之东流
魁力	魅力
卓智多谋	卓智多谋
精神矍烁	精神矍铄
稍安毋躁	少安毋躁
姿意妄为	恣意妄为
沽恶不悛	怙恶不悛
穷原竞委	穷原竟委
弄巧成绌	弄巧成拙
随声附合	随声附和
亲睐	青睐
犹柔寡断	优柔寡断
莫可明状	莫可名状
气势凶凶	气势凶凶
尽心极力	尽心极力
雀巢鸠占	鹊巢鸠占
不落巢臼	不落窠臼
肿涨	肿胀
瞑思苦想	冥思苦想
竭见	谒见
励兵秣马	厉兵秣马
出奇不意	出其不意
默挈	默契
一幅对联	一副对联
原形必露	原形毕露
眼急手快	眼疾手快
遭秧	遭殃
司空见怪	司空见惯
一鼓足气	一鼓足气
励行节约	厉行节约
风尘扑扑	风尘仆仆
击浊扬清	激浊扬清
摒气凝神	屏气凝神
拾遗补缺	拾遗补阙
度过难关	渡过难关
异曲同功	异曲同工
独具惠眼	独具慧眼
清辙	清澈
传颂一时	传诵一时
过尤不及	过犹不及
膈膜	隔膜
划地为牢	画地为牢
贪脏枉法	贪赃枉法
挑肥捡瘦	挑肥拣瘦
永保青春	永葆青春
皎皎者	佼佼者
挠恕	饶恕
各书己见	各抒己见
借戒	借鉴
势如爆竹	势如爆竹
翱游	遨游
切搓琢磨	切磋琢磨
隐隐绰绰	影影绰绰
飞机着落	飞机着落
震震有词	振振有词
愤闷不平	懑闷不平
图穷匕现	图穷匕见
不能自己	不能自已
忽然开朗	豁然开朗
暖哄哄	暖烘烘
千头万序	千头万绪
无精打采	无精打彩
玷玷自喜	沾沾自喜
变本加利	变本加厉
兴高彩烈	兴高采烈
决对	绝对
扇风点火	煽风点火
无尚光荣	无上光荣
汗流夹背	汗流浃背
卓智多谋	足智多谋
拒谏是非	拒谏饰非
亵赎	亵赎
性格粗旷	性格粗犷
棉里藏针	绵里藏针
频临	濒临
垮台	垮台
追本朔源	追本溯源
浑浑恶恶	浑浑噩噩
抿灭	泯灭
无所是从	无所适从
作崇	作祟
愤世疾俗	愤世嫉俗
艰苦倍尝	艰苦备尝
闲情逸志	闲情逸致
蓦捐	募捐
猩猩作态	惺惺作态
吃里爬外	吃里扒外
昙花一显	昙花一现
彬彬有理	彬彬有礼
首当其充	首当其冲
自曝自弃	自暴自弃
精兵减政	精兵简政
委糜	委靡
砥毁	诋毁
事绩	事迹
忘恩负意	忘恩负义
草木雕零	草木凋零
纭纭众生	芸芸众生
绌绌逼人	咄咄逼人
浸人心脾	沁人心脾
毋用讳言	毋庸讳言
刻己奉公	克己奉公
山峦重迭	山峦重叠
墨守陈规	墨守成规
震憾人心	震撼人心
真象大白	真相大白
美仑美奂	美轮美奂
居心不测	居心不测
慢谈	漫谈
响彻云宵	响彻云霄
独劈蹊径	独辟蹊径
决无仅有	绝无仅有
防患未燃	防患未然
调察	调查
无讥之谈	无稽之谈
偕书	楷书
贯输知识	灌输知识
关怀倍至	关怀备至
伤天害礼	伤天害理
坐地分脏	坐地分赃
清淅	清晰
不落巢臼	不落巢臼
扬扬洒洒	洋洒洒洒洒
少纵即逝	稍纵即逝
誉写	誊写
调济	调剂
言简意该	言简意赅
白头携老	白头偕老
蓬头诟面	蓬头垢面
流言非语	流言蜚语
按磨	按摩
直言不晦	直言不讳
噬脐莫急	噬脐莫及
跃武扬威	耀武扬威
大姆指	大拇指
推脱	推托
记忆尤新	记忆犹新
恶耗	噩耗
不卑不吭	不卑不吭
生灵涂碳	生灵涂炭
暴炸	爆炸
沤吐	呕吐
联襟	连襟
自名不凡	自命不凡
暂露头角	崭露头角
震奋	振奋
明片	名片
怨天犹人	怨天尤人
愤笔急书	奋笔疾书
推脱生病	推托生病
无计于事	无济于事
聆吟	聆听
严正申明	严声声明
倒打一把	倒打一耙
继往不究	既往不究
原物必还	原物璧还
游戈	游弋
通情达礼	通情达理
死心踏地	死心塌地
洁白无暇	洁白无瑕
